12 12
11 11
XXXXXXXXXXXX
XXXt..XX.XXX
XXX.......XX
X........XX
XXXX...XXXXX
XX.X..XXXXXX
XXX...XXXXXX
XXXX..XXX..X
XXXX.....XXX
XXXXXX.XXXXX
XXXXXX...XXX
XXXXXXXXXXXX
