12 12
11 2
XXXXXXXXXXXX
XXXXXXXXXXXX
XXXXXXXXXXXX
XXXXXXXXXXXX
X..XXXXXXXXX
X..XXtXXXXXX
X..X...XXXXX
XX.X.XXXXXXX
XX.X.XXXXXXX
X..X.XXXXXXX
X.XX.XXXXXXX
X......XXXXX