12 12
11 11
XXXXXXXXXXXX
XXXt..XX.XXX
XXX.......XX
X..XXXXXXX.X
XXXXX..XXXXX
XX.X..XXXXXX
XXX..XXXXXXX
XXXX..XXX..X
XXXX.....XXX
XXXXXX.XXXXX
XXXXXX...XXX
XXXXXXXXXXXX
