10 10
9 1
XXXXXXXXXX
XXX.XX.tXX
XXXX.X.XXX
X.XXX...XX
XX.XXXX..X
XXXXX.XX.X
XX.XX..X.X
XX.XXXX..X
XXX.XX.XXX
XXXXXXXXXX