10 10
8 2
XXXXXXXXXX
XXX.XX.tXX
XXXX.X.XXX
X.XXX...XX
XX.XXXX..X
XXXXX.XX.X
XX.XX..X.X
XX.XXXX..X
X...XX.XXX
XXXXXXXXXX