12 12
10 10
XXXXXXXXXXXX
XXXt..XX.XXX
XXX.......XX
X........XXX
XXXX...XXXXX
XX.X..XXXXXX
XXX...XXXXXX
XXXX..XXX..X
XXXX.......X
XXXXXX.XXXXX
XXXXXX.....X
XXXXXXXXXXXX
